NO ./path_to_the_north_texture
SO ./path_to_the_south_texture
WE ./path_to_the_west_texture
EA ./path_to_the_east_texture

F 220,100,0
C 225,30,0


     11111111111 11111111111111
     10000000001 10000000000001
     10110000011110000000000001
     100100000000000000000000111111
  111111111011000001110000000000001
    1000000011000001110111111111111
  1111011111111101110000001
  11110111111111011101010011111
  11000000110101011100000010001
  10000000000000001100000000001
  10000000000000001101010010001                 
  11000001110101011111011110N0111
  11110111 1110101 101111010001
  11111111 1111111 111111111111



