NO ./path_to_the_north_texture
SO ./path_to_the_south_texture
WE ./path_to_the_west_texture
EA ./path_to_the_east_texture

F 220,100,0
C 225,30,0


     11111111111 11111111111111
     10000000001 10000000000001
     10110000011 110000000000011
     10010000001 1000000000000111111
  11111111101101 101110000000000001
    100000001101 101110111111111111
  11111111111111 1111111111
 
  11111111111111 111111111111111
  11000000110101 11100000010001
  10000000000001 11100000000001
  10000000000001 11101010010001
  11000001110101 11111011110N0111
  11110111 11101 1 101111010001
  11111111 11111 1 111111111111



